10 10
2 1
6 7
2 4 2 1 4 5 2 0 1 2
0 1 2 3 5 3 1 3 1 0
2 0 4 4 0 2 4 2 3 1
2 5 5 3 2 0 1 4 2 0
4 3 3 2 1 0 1 1 0 1
1 2 0 2 1 1 4 2 0 2
2 0 4 4 0 2 4 2 4 2
2 5 5 3 2 0 1 4 3 1
2 0 4 4 0 2 4 2 2 1
2 5 5 3 2 0 1 4 2 3